🟧🟧🟧🟧🟧🟧🟧🟧🟧🟧🟧🟧
🟧󠀠󠀠󠀠󠀠󠀠⬜🟩⬜🟩🟩⬜⬜📦⬜⬜🟧
🟧⬜📦⬜⬜⬜⬜⬜⬜⬜⬜🟧
🟧⬜🤠⬜⬜⬜⬜⬜⬜⬜⬜🟧
🟧⬜📦⬜📦⬜⬜⬜⬜⬜⬜🟧
🟧⬜🟩⬜⬜⬜⬜⬜⬜⬜⬜🟧
🟧🟧🟧🟧🟧🟧🟧🟧🟧🟧🟧🟧