🟧🟧🟧🟧🟧🟧🟧🟧🟧🟧🟧🟧
🟧󠀠󠀠󠀠󠀠󠀠🟩⬜⬜⬜⬜⬜⬜⬜📦🟩🟧
🟧⬜📦⬜⬜⬜⬜⬜⬜📦🟩🟧
🟧⬜🤠⬜⬜⬜⬜⬜⬜📦🟩🟧
🟧⬜⬜⬜⬜⬜⬜⬜⬜📦🟩🟧
🟧⬜⬜⬜⬜⬜⬜⬜⬜📦🟩🟧
🟧🟧🟧🟧🟧🟧🟧🟧🟧🟧🟧🟧