🟧🟧🟧🟧🟧🟧🟧🟧🟧
🟧󠀠󠀠󠀠󠀠󠀠⬜🟩⬜⬜⬜⬜⬜🟧
🟧⬜📦⬜📦⬜📦⬜🟧
🟧⬜🤠⬜🟧🟧🟧⬜🟧
🟧⬜📦⬜🟧🟧🟧🟩🟧
🟧⬜🟩⬜🟧🟧🟧🟩🟧
🟧🟧🟧🟧🟧🟧🟧🟧🟧