🟧🟧🟧🟧🟧🟧🟧🟧🟧🟧🟧🟧
🟧󠀠󠀠󠀠󠀠󠀠⬜🟩⬜⬜⬜⬜⬜⬜⬜⬜🟧
🟧⬜📦⬜⬜⬜⬜⬜⬜⬜⬜🟧
🟧⬜🤠⬜⬜⬜⬜⬜⬜⬜⬜🟧
🟧⬜📦⬜⬜⬜⬜⬜⬜⬜⬜🟧
🟧⬜🟩⬜⬜⬜⬜⬜⬜⬜⬜🟧
🟧🟧🟧🟧🟧🟧🟧🟧🟧🟧🟧🟧