🟧🟧🟧🟧🟧🟧🟧🟧🟧🟧🟧🟧
🟧󠀠󠀠󠀠󠀠󠀠⬜🟩⬜🟩🟩⬜⬜📦⬜⬜🟧
🟧⬜📦⬜⬜⬜⬜⬜⬜⬜⬜🟧
🟧⬜🤠⬜⬜⬜⬜⬜⬜⬜⬜🟧
🟧⬜📦⬜📦⬜⬜⬜⬜⬜⬜🟧
🟧⬜🟩⬜⬜⬜⬜📦⬜🟩⬜🟧
🟧🟧🟧🟧🟧🟧🟧🟧🟧🟧🟧🟧