🟧🟧🟧🟧🟧🟧🟧🟧🟧🟧🟧🟧
🟧󠀠󠀠󠀠󠀠󠀠⬜🟩⬜⬜⬜⬜⬜⬜⬜⬜🟧
🟧⬜📦⬜⬜⬜⬜⬜⬜⬜⬜🟧
🟧⬜🤠📦🟩⬜⬜⬜⬜⬜⬜🟧
🟧⬜📦⬜⬜⬜⬜⬜⬜⬜⬜🟧
🟧⬜🟩⬜⬜⬜⬜⬜⬜⬜⬜🟧
🟧🟧🟧🟧🟧🟧🟧🟧🟧🟧🟧🟧