🟧🟧🟧🟧🟧🟧🟧🟧🟧
🟧󠀠󠀠󠀠󠀠󠀠⬜🟩⬜⬜⬜⬜⬜🟧
🟧⬜📦⬜⬜⬜📦⬜🟧
🟧⬜🤠⬜🟧🟧🟧⬜🟧
🟧⬜📦⬜🟧🟧🟧⬜🟧
🟧⬜🟩⬜🟧🟧🟧🟩🟧
🟧🟧🟧🟧🟧🟧🟧🟧🟧